#########################
#....#.............#....#
#.##.# ########### #.##.#
#.#                   #.#
#.# ## ####   #### ## #.#
#.#    #...   ...#    #.#
#   ## ########### ##  .#
#.#                   #.#
#.# ## ########### ## #.#
#.# . .............   #.#
#.##.# ########### #.##.#
#....#             #....#
#########################