#########################
#....#..........#.......#
#.##.# ######## #.###...#
#.#                 #...#
#.# ## ###   ####   #...#
#.#....#        #   #...#
#...## ##########    ...#
#.#                 #...#
#.# ## ###   ### ## #...#
#.#.................#...#
#.##.# ########### ##...#
#....#              ....#
#########################