#########################
#....#....###....#......#
#.##.# ##     ## #.##.#.#
#.#.....................#
#.# ## #### ######.## #.#
#.#    #         #     .#
#   ## ########### ## #.#
#.#     ........      #.#
#.# ## ########### ## #.#
#.#                   #.#
#.##.# ########### #.##.#
#....#  .........  #....#
#########################