######################
#....#          #....#
#.##.# ######## #.##.#
#.#                #.#
#.# ## ###  ### #  #.#
#.#    #      #    #.#
#   ## ######## ##  .#
#.#                #.#
#.# ## ######## ## #.#
#.# . ..........   #.#
#.##.# ######## #.##.#
#....# ........ #....#
######################